const short testeMap1_map[25][20] = {
{ 3, 3, 3, 3, 3, 3, 3, 3, 3, 3, 3, 3, 3, 3, 3, 3, 
3, 3, 3, 3 },
{ 0, 0, 0, 0, 0, 0, 0, 0, 0, 6, 0, 0, 0, 0, 6, 0, 
0, 0, 0, 0 },
{ 0, 0, 0, 0, 0, 0, 0, 0, 0, 0, 1, 1, 1, 1, 0, 0, 
0, 0, 0, 0 },
{ 0, 0, 4, 0, 0, 0, 0, 0, 0, 0, 1, 1, 1, 1, 0, 0, 
4, 0, 0, 0 },
{ 0, 0, 0, 0, 0, 0, 0, 0, 0, 0, 1, 1, 1, 1, 0, 0, 
0, 0, 0, 0 },
{ 0, 0, 0, 0, 0, 0, 0, 0, 0, 0, 1, 1, 1, 1, 0, 0, 
0, 0, 0, 0 },
{ 6, 0, 0, 0, 0, 6, 0, 0, 0, 6, 0, 0, 0, 0, 6, 0, 
0, 0, 0, 6 },
{ 0, 1, 1, 1, 1, 0, 0, 0, 0, 0, 0, 0, 0, 0, 0, 1, 
1, 1, 1, 0 },
{ 0, 1, 1, 1, 1, 0, 0, 0, 0, 0, 0, 0, 0, 0, 0, 1, 
1, 1, 1, 0 },
{ 0, 1, 1, 1, 1, 0, 0, 0, 0, 0, 0, 4, 0, 0, 0, 1, 
1, 1, 1, 0 },
{ 0, 1, 1, 1, 1, 0, 0, 0, 0, 0, 0, 0, 0, 0, 0, 1, 
1, 1, 1, 0 },
{ 6, 0, 0, 0, 0, 6, 0, 0, 0, 0, 0, 0, 0, 0, 6, 0, 
0, 0, 0, 6 },
{ 2, 0, 0, 0, 0, 0, 0, 0, 0, 6, 0, 0, 0, 0, 0, 0, 
6, 0, 0, 0 },
{ 2, 0, 0, 0, 0, 0, 0, 0, 0, 0, 1, 3, 3, 3, 3, 1, 
0, 0, 0, 4 },
{ 2, 0, 0, 1, 1, 1, 1, 1, 1, 1, 3, 0, 0, 0, 0, 3, 
0, 0, 0, 0 },
{ 2, 0, 0, 1, 1, 1, 1, 1, 1, 1, 3, 0, 0, 0, 0, 3, 
6, 0, 0, 6 },
{ 2, 0, 0, 0, 0, 0, 0, 0, 0, 0, 3, 0, 0, 0, 0, 3, 
3, 3, 3, 3 },
{ 2, 0, 0, 0, 0, 0, 0, 0, 0, 0, 1, 0, 0, 0, 0, 0, 
0, 0, 0, 0 },
{ 2, 2, 2, 2, 2, 1, 0, 0, 0, 0, 3, 0, 0, 3, 3, 3, 
3, 3, 3, 3 },
{ 0, 0, 0, 0, 0, 1, 0, 0, 0, 0, 3, 0, 0, 3, 0, 0, 
0, 0, 0, 0 },
{ 0, 0, 0, 0, 0, 1, 0, 0, 0, 6, 3, 0, 0, 3, 0, 6, 
0, 4, 0, 6 },
{ 0, 0, 0, 0, 0, 1, 0, 0, 0, 0, 2, 2, 2, 2, 0, 0, 
0, 0, 0, 0 },
{ 0, 0, 0, 0, 0, 1, 0, 0, 0, 0, 0, 0, 0, 0, 0, 0, 
2, 2, 2, 3 },
{ 0, 0, 0, 0, 0, 1, 0, 0, 0, 0, 2, 2, 2, 2, 0, 0, 
2, 0, 0, 0 },
{ 0, 0, 0, 0, 0, 1, 0, 0, 5, 0, 1, 0, 0, 1, 0, 0, 
2, 0, 0, 0 }
};

