var map[10][10] = {
{ 2, 2, 2, 2, 2, 2, 2, 2, 2, 0 },
{ 2, 0, 0, 0, 0, 0, 0, 0, 2, 0 },
{ 2, 0, 0, 4, 1, 0, 0, 0, 2, 0 },
{ 2, 0, 0, 0, 0, 0, 0, 0, 2, 0 },
{ 2, 13, 0, 0, 0, 0, 0, 13, 2, 0 },
{ 2, 0, 0, 0, 0, 0, 0, 0, 2, 0 },
{ 2, 11, 0, 0, 0, 0, 11, 8, 2, 0 },
{ 2, 0, 0, 4, 2, 2, 2, 2, 2, 0 },
{ 2, 0, 0, 0, 0, 0, 0, 7, 2, 0 },
{ 2, 2, 2, 2, 2, 2, 2, 2, 2, 0 }
};

