var map[10][10] = {
{ 1, 1, 1, 1, 1, 1, 1, 1, 1, 0 },
{ 1, 0, 0, 0, 8, 0, 0, 0, 1, 0 },
{ 1, 0, 0, 0, 0, 0, 0, 0, 1, 0 },
{ 1, 11, 0, 0, 4, 0, 0, 11, 1, 0 },
{ 1, 0, 2, 2, 2, 2, 2, 0, 1, 0 },
{ 1, 0, 2, 2, 2, 2, 2, 0, 1, 0 },
{ 1, 11, 0, 0, 4, 0, 0, 11, 1, 0 },
{ 1, 0, 0, 0, 0, 0, 0, 0, 1, 0 },
{ 1, 0, 0, 0, 7, 0, 0, 0, 1, 0 },
{ 1, 1, 1, 1, 1, 1, 1, 1, 1, 0 }
};

