var map[10][10] = {
{ 3, 3, 3, 3, 3, 3, 3, 3, 3, 0 },
{ 1, 0, 0, 0, 8, 0, 0, 0, 1, 0 },
{ 1, 0, 0, 0, 0, 0, 0, 0, 1, 0 },
{ 1, 12, 0, 0, 0, 0, 0, 12, 1, 0 },
{ 1, 0, 4, 2, 2, 2, 4, 0, 1, 0 },
{ 1, 0, 0, 3, 3, 3, 0, 0, 1, 0 },
{ 1, 11, 0, 0, 0, 0, 0, 11, 1, 0 },
{ 1, 0, 0, 0, 0, 0, 0, 0, 1, 0 },
{ 1, 0, 0, 0, 7, 0, 0, 0, 1, 0 },
{ 1, 1, 1, 1, 1, 1, 1, 1, 1, 0 }
};

