var map[10][10] = {
{ 0, 1, 1, 1, 1, 1, 1, 1, 1, 1 },
{ 0, 1, 0, 0, 0, 0, 0, 0, 3, 1 },
{ 0, 1, 0, 2, 3, 0, 0, 0, 3, 1 },
{ 0, 1, 0, 2, 3, 0, 0, 0, 3, 1 },
{ 0, 1, 0, 2, 3, 0, 0, 0, 3, 1 },
{ 0, 1, 0, 2, 3, 4, 4, 8, 3, 1 },
{ 0, 1, 0, 2, 3, 3, 3, 3, 3, 1 },
{ 0, 1, 0, 2, 2, 2, 2, 2, 2, 1 },
{ 0, 1, 0, 0, 0, 0, 0, 0, 7, 1 },
{ 0, 1, 1, 1, 1, 1, 1, 1, 1, 1 }
};

