var map[10][10] = {
{ 1, 1, 1, 1, 1, 1, 1, 1, 1, 0 },
{ 1, 0, 0, 0, 8, 0, 0, 0, 1, 0 },
{ 1, 0, 3, 3, 3, 3, 3, 0, 1, 0 },
{ 1, 0, 3, 0, 0, 0, 3, 0, 1, 0 },
{ 1, 0, 3, 0, 0, 0, 3, 0, 1, 0 },
{ 1, 4, 3, 3, 3, 3, 3, 4, 1, 0 },
{ 1, 0, 0, 0, 0, 0, 0, 0, 1, 0 },
{ 1, 0, 0, 0, 0, 0, 0, 0, 1, 0 },
{ 1, 0, 0, 0, 7, 0, 0, 0, 1, 0 },
{ 1, 1, 1, 1, 1, 1, 1, 1, 1, 0 }
};

